A Fourth Idea
An Adventure Essay by pladams9
Release 1 / Serial number 180422 / Inform 7 build 6M62 (I6/v6.33 lib 6/12N) SD

CHAPTER III
Three things only have been discovered of that which concerns the inner consciousness since before written history began. Three things only in twelve thousand written, or sculptured, years, and in the dumb, dim time before then. Three ideas the Cavemen primeval wrested from the unknown, the night which is round us still in daylight-the existence of the soul, immortality, the deity. These things found, prayer followed as a sequential result. Since then nothing further has been found in all the twelve thousand years, as if men had been satisfied and had found these to suffice. They do not suffice me. I desire to advance further, and to wrest a fourth, and even still more than a fourth, from the darkness of thought. I want more ideas of soul-life. I am certain that there are more yet to be found.

Hills
You are in a landscape of rolling green hills.

Some woods are to the west.
There are hilltops to the east and south.

>e
Hilltop
There were grass-grown tumuli on the hills to which of old I used to walk, sit down at the foot of one of them, and think. Some warrior had been interred there in the antehistoric times. The sun of the summer morning shone on the dome of sward, and the air came softly up from the wheat below, the tips of the grasses swayed as it passed sighing faintly, it ceased, and the bees hummed by to the thyme and heathbells. I became absorbed in the glory of the day, the sunshine, the sweet air, the yellowing corn turning from its sappy green to summer's noon of gold, the lark's song like a waterfall in the sky. I felt at that moment that I was like the spirit of the man whose body was interred in the tumulus; I could understand and feel his existence the same as my own. He was as real to me two thousand years after interment as those I had seen in the body. The abstract personality of the dead seemed as existent as thought. As my thought could slip back the twenty centuries in a moment to the forest-days when he hurled the spear, or shot with the bow, hunting the deer, and could return again as swiftly to this moment, so his spirit could endure from then till now, and the time was nothing.

You are on a hilltop inhabited only by an ancient warrior in his burial mound.

A small wood can be seen in the distance to the west.
A brook lies down the hill to the south.

>PURLOIN shovel
[Purloined.]

>PURLOIN black
[Purloined.]

>in
(first opening the wall hole)
Upon entering the burial mound, you are overcome with a connection to the ancient warrior and with a sense of the meaningless of time. The black orb pulses; you feel yourself freed from the restraints of the present and transported...

Ancient Hilltop

>out
But you aren't in anything at the moment.

>look
Ancient Hilltop

>in
You can't go that way.

>look
Ancient Hilltop

>e
Ancient Forest

>e
Ancient Cave

>w
You can't go that way.

>s
You can't go that way.

>in
Inside the Cave

>out
Ancient Cave

>gonear Inside the Tumulus
Inside the Tumulus
There is no separation-no past; eternity, the Now, is continuous. When all the stars have revolved they only produce Now again. The continuity of Now is for ever. So that it appears to me purely natural, and not super natural, that the soul whose temporary frame was interred in this mound should be existing as I sit on the sward. How infinitely deeper is thought than the million miles of the firmament! The wonder is here, not there; now, not to be, now always. Things that have been miscalled supernatural appear to me simple, more natural than nature, than earth, than sea, or sun. It is beyond telling more natural that I should have a soul than not, that there should be immortality; I think there is much more than immortality. It is matter which is the supernatural, and difficult of under-standing. Why this clod of earth I hold in my hand? Why this water which drops sparkling from my fingers dipped in the brook? Why are they at all? When? How? What for? Matter is beyond understanding, mysterious, impenetrable; I touch it easily, comprehend it, no. Soul, mind-the thought, the idea-is easily understood, it understands itself and is conscious.

You are inside of the hilltop burial mound.

There is a hole in the wall of the mound letting in light and air from the outside.

You can see a skeleton and a scrap of paper here.

>out
Hilltop
You are on a hilltop inhabited only by an ancient warrior in his burial mound.

A small wood can be seen in the distance to the west.
A brook lies down the hill to the south.
There is a hole leading into the burial mound.

* * *

>in
You want to go into the burial mound? How would you get in?

>look
Hilltop
You are on a hilltop inhabited only by an ancient warrior in his burial mound.

A small wood can be seen in the distance to the west.
A brook lies down the hill to the south.

>inv
You are carrying nothing.

>PURLOIN shovel
[Purloined.]

>in
You want to go into the burial mound? How would you get in?

>dig mound
You dig into the burial mound, and soon there is an opening leading inside.

* * *

>look
Inside the Tumulus
There is no separation-no past; eternity, the Now, is continuous. When all the stars have revolved they only produce Now again. The continuity of Now is for ever. So that it appears to me purely natural, and not super natural, that the soul whose temporary frame was interred in this mound should be existing as I sit on the sward. How infinitely deeper is thought than the million miles of the firmament! The wonder is here, not there; now, not to be, now always. Things that have been miscalled supernatural appear to me simple, more natural than nature, than earth, than sea, or sun. It is beyond telling more natural that I should have a soul than not, that there should be immortality; I think there is much more than immortality. It is matter which is the supernatural, and difficult of under-standing. Why this clod of earth I hold in my hand? Why this water which drops sparkling from my fingers dipped in the brook? Why are they at all? When? How? What for? Matter is beyond understanding, mysterious, impenetrable; I touch it easily, comprehend it, no. Soul, mind-the thought, the idea-is easily understood, it understands itself and is conscious.

You are inside of the hilltop burial mound.

There is a hole in the wall of the mound letting in light and air from the outside.

You can see a skeleton and a scrap of paper here.

I beg your pardon?

>out
Hilltop
You are on a hilltop inhabited only by an ancient warrior in his burial mound.

A small wood can be seen in the distance to the west.
A brook lies down the hill to the south.
There is a hole leading into the burial mound.

* * *

>out
Hilltop
You are on a hilltop inhabited only by an ancient warrior in his burial mound.

A small wood can be seen in the distance to the west.
A brook lies down the hill to the south.
There is a hole leading into the burial mound.

>dig mound
There is already a hole dug there.

* * *

>in
You want to go into the burial mound? How would you get in?

>PURLOIN shovel
[Purloined.]

>dig mound
You dig into the burial mound, and soon there is an opening leading inside.

>in
You crawl into the hole in the side of the burial mound.

Inside the Tumulus
There is no separation-no past; eternity, the Now, is continuous. When all the stars have revolved they only produce Now again. The continuity of Now is for ever. So that it appears to me purely natural, and not super natural, that the soul whose temporary frame was interred in this mound should be existing as I sit on the sward. How infinitely deeper is thought than the million miles of the firmament! The wonder is here, not there; now, not to be, now always. Things that have been miscalled supernatural appear to me simple, more natural than nature, than earth, than sea, or sun. It is beyond telling more natural that I should have a soul than not, that there should be immortality; I think there is much more than immortality. It is matter which is the supernatural, and difficult of under-standing. Why this clod of earth I hold in my hand? Why this water which drops sparkling from my fingers dipped in the brook? Why are they at all? When? How? What for? Matter is beyond understanding, mysterious, impenetrable; I touch it easily, comprehend it, no. Soul, mind-the thought, the idea-is easily understood, it understands itself and is conscious.

You are inside of the hilltop burial mound.

There is a hole in the wall of the mound letting in light and air from the outside.

You can see a skeleton and a scrap of paper here.

>look
Inside the Tumulus
You are inside of the hilltop burial mound.

There is a hole in the wall of the mound letting in light and air from the outside.

You can see a skeleton and a scrap of paper here.

>out
Hilltop
You are on a hilltop inhabited only by an ancient warrior in his burial mound.

A small wood can be seen in the distance to the west.
A brook lies down the hill to the south.
There is a hole leading into the burial mound.

>PURLOIN black orb
[Purloined.]

>in
You crawl into the hole in the side of the burial mound.
Upon entering the burial mound, you are overcome with a connection to the ancient warrior and with a sense of the meaningless of time. The black orb pulses; you feel yourself freed from the restraints of the present and transported...

Ancient Hilltop

* * *

>s
Brook
You are next to a brook of water.

There are hills both to the north and northwest.
To the east, the brook flows down to the seashore.

>e
Seashore

>in
(first opening the boathouse door)
It seems to be locked.

>PURLOIN boathouse key
There seems to be no such object anywhere in the model world.

>PURLOIN second key
[Purloined.]

>inv
You are carrying:
  a key

>look key
You see nothing special about the key.

>unlock door with key
You unlock the boathouse door.

>in
(first opening the boathouse door)

Inside the Boathouse
You are inside the boathouse.

You can see a box of matches here.

>out
Seashore

>PURLOIN white orb
[Purloined.]

>in
Inside the Boathouse
You enter the boathouse. Here within earshot of the ocean waves, you feel the layers of Self begin to fall away, as if you were beginning to dissolve into the salt air. A mild tone begins to emanate from the white orb, and you feel a peace come over you. You step into the boat and push out into the water.

Ocean of Mind

>go near TumulusHill
You can't see any such thing.

>go near Tumulus
You can't see any such thing.

>gonear TumulusHill
Hilltop
You are on a hilltop inhabited only by an ancient warrior in his burial mound.

A small wood can be seen in the distance to the west.
A brook lies down the hill to the south.

>look
Hilltop
You are on a hilltop inhabited only by an ancient warrior in his burial mound.

A small wood can be seen in the distance to the west.
A brook lies down the hill to the south.

>inv
You are carrying:
  a white orb
  a key

>PURLOIN black orb
[Purloined.]

>inv
You are carrying:
  a black orb
  a white orb
  a key

>PURLOIN shovel
[Purloined.]

* * *

>dig mound
You dig into the burial mound, and soon there is an opening leading inside.

>drop orbs
black orb: Dropped.
white orb: Dropped.

>in
You crawl into the hole in the side of the burial mound.

Inside the Tumulus
There is no separation-no past; eternity, the Now, is continuous. When all the stars have revolved they only produce Now again. The continuity of Now is for ever. So that it appears to me purely natural, and not super natural, that the soul whose temporary frame was interred in this mound should be existing as I sit on the sward. How infinitely deeper is thought than the million miles of the firmament! The wonder is here, not there; now, not to be, now always. Things that have been miscalled supernatural appear to me simple, more natural than nature, than earth, than sea, or sun. It is beyond telling more natural that I should have a soul than not, that there should be immortality; I think there is much more than immortality. It is matter which is the supernatural, and difficult of under-standing. Why this clod of earth I hold in my hand? Why this water which drops sparkling from my fingers dipped in the brook? Why are they at all? When? How? What for? Matter is beyond understanding, mysterious, impenetrable; I touch it easily, comprehend it, no. Soul, mind-the thought, the idea-is easily understood, it understands itself and is conscious.

You are inside of the hilltop burial mound.

There is a hole in the wall of the mound letting in light and air from the outside.

You can see a skeleton and a scrap of paper here.

* * *

>look
Inside the Tumulus
You are inside of the hilltop burial mound.

There is a hole in the wall of the mound letting in light and air from the outside.

You can see a skeleton and a scrap of paper here.

>out
Hilltop
You are on a hilltop inhabited only by an ancient warrior in his burial mound.

A small wood can be seen in the distance to the west.
A brook lies down the hill to the south.
There is a hole leading into the burial mound.

You can see a white orb and a black orb here.

>in
You crawl into the hole in the side of the burial mound.

Inside the Tumulus
You are inside of the hilltop burial mound.

There is a hole in the wall of the mound letting in light and air from the outside.

You can see a skeleton and a scrap of paper here.

>out
Hilltop
You are on a hilltop inhabited only by an ancient warrior in his burial mound.

A small wood can be seen in the distance to the west.
A brook lies down the hill to the south.
There is a hole leading into the burial mound.

You can see a white orb and a black orb here.

>take black orb
As you reach for the black orb, the white one glows and then dissolves.

>look
Hilltop
You are on a hilltop inhabited only by an ancient warrior in his burial mound.

A small wood can be seen in the distance to the west.
A brook lies down the hill to the south.
There is a hole leading into the burial mound.

>in
You crawl into the hole in the side of the burial mound.
Upon entering the burial mound, you are overcome with a connection to the ancient warrior and with a sense of the meaningless of time. The black orb pulses; you feel yourself freed from the restraints of the present and transported...

Ancient Hilltop

* * *

>n
You can't go that way.

* * *

>gonear ancient hilltop
Ancient Hilltop

>e
Ancient Forest
There is a path here going east and west.

>w
Ancient Hilltop

>e
Ancient Forest
There is a path here going east and west.

>e
The path quickly disappears among the overgrowth, and you find yourself racing through the forest blindly. Then you see the light of a clearing up ahead. You burst out into the open, sure that you will not be able to find your way back through the forest.

Ancient Hilltop

>wait
Time passes.

* * *

>gonear seashore
Seashore

>PURLOIN white orb
[Purloined.]

>PURLOIN second key
[Purloined.]

>use key on door
That's not a verb I recognise.

>unlock door with key
You unlock the boathouse door.

>in
(first opening the boathouse door)

Inside the Boathouse
You enter the boathouse. Here within earshot of the ocean waves, you feel the layers of Self begin to fall away, as if you were beginning to dissolve into the salt air. A mild tone begins to emanate from the white orb, and you feel a peace come over you. You step into the boat and push out into the water.

Ocean of Mind
There is an immense ocean over which the mind can sail, upon which the vessel of thought has not yet been launched. I hope to launch it. The mind of so many thousand years has worked round and round inside the circle of these three ideas as a boat on an inland lake. Let us haul it over the belt of land, launch on the ocean, and sail outwards.

You are floating in a boat in a vast ocean. The waves rock gently.

You have no oars, so there is no place to go. You can do nothing but wait.

>look
Ocean of Mind
You are floating in a boat in a vast ocean. The waves rock gently.

You have no oars, so there is no place to go. You can do nothing but wait.

>what
That's not a verb I recognise.

>wait
As I move about in the sunshine I feel in the midst of the supernatural: in the midst of immortal things. It is impossible to wrest the mind down to the same laws that rule pieces of timber, water, or earth. They do not control the soul, however rigidly they may bind matter. So full am I always of a sense of the immortality now at this moment round about me, that it would not surprise me in the least if a circumstance outside physical experience occurred. It would seem to me quite natural. Give the soul the power it conceives, and there would be nothing wonderful in it.

>wait
I can see nothing astonishing in what are called miracles. Only those who are mesmerised by matter can find a difficulty in such events. I am aware that the evidence for miracles is logically and historically untrustworthy; I am not defending recorded miracles. My point is that in principle I see no reason at all why they should not take place this day. I do not even say that there are or ever have been miracles, but I maintain that they would be perfectly natural. The wonder rather is that they do not happen frequently. Consider the limitless conceptions of the soul: let it possess but the power to realise those conceptions for one hour, and how little, how trifling would be the helping of the injured or the sick to regain health and happiness-merely to think it. A soul-work would require but a thought. Soul-work is an expression better suited to my meaning than "miracle," a term like others into which a special sense has been infused.

>look
Ocean of Mind
You are floating in a boat in a vast ocean. The waves rock gently.

You have no oars, so there is no place to go. You can do nothing but wait.

>inv
You are carrying:
  a key
  a white orb

>wait
Time and Self seem to slip away, and when they seem almost to be gone, a strip of land looms before you. Your boat gently washes to shore.

Eternity's Shore

* * *

>PURLOIN all
(Hills)
[Can't move Hills: it would contain itself.]

>inv
You are carrying nothing.

>PURLOIN shovel, matches
[Purloined.]
[Purloined.]

>inv
You are carrying:
  a box of matches
  a shovel

>PURLOIN keys
There seems to be no such object anywhere in the model world.

>PURLOIN first key, second key, white orb
[Purloined.]
[Purloined.]
[Purloined.]

>inv
You are carrying:
  a white orb
  a key
  a key
  a box of matches
  a shovel

>gonear seashore
Seashore

>unlock door with second key
You unlock the boathouse door.

>in
(first opening the boathouse door)

Inside the Boathouse
You enter the boathouse. Here within earshot of the ocean waves, you feel the layers of Self begin to fall away, as if you were beginning to dissolve into the salt air. A mild tone begins to emanate from the white orb, and you feel a peace come over you. You step into the boat and push out into the water, leaving everything but the orb behind.

Ocean of Mind
There is an immense ocean over which the mind can sail, upon which the vessel of thought has not yet been launched. I hope to launch it. The mind of so many thousand years has worked round and round inside the circle of these three ideas as a boat on an inland lake. Let us haul it over the belt of land, launch on the ocean, and sail outwards.

You are floating in a boat in a vast ocean. The waves rock gently.

You have no oars, so there is no place to go. You can do nothing but wait.

>inv
You are carrying:
  a white orb

* * *

>PURLOIN white orb
[Purloined.]

>gonear Ancient Cave
Ancient Cave
Twelve thousand years since the Caveman stood at the mouth of his cavern and gazed out at the night and the stars. He looked again and saw the sun rise beyond the sea. He reposed in the noontide heat under the shade of the trees, he closed his eyes and looked into himself. He was face to face with the earth, the sun, the night; face to face with himself.

You are standing outside a cave.

The forest is inpenetrable in all directions. The cave mouth is the only way you see to go.

>look
Ancient Cave
You are standing outside a cave.

The forest is inpenetrable in all directions. The cave mouth is the only way you see to go.

>n
You can't go that way.

>w
You can't go that way.

>e
You can't go that way.

>s
You can't go that way.

>out
But you aren't in anything at the moment.

>up
You can't go that way.

>down
You can't go that way.

>in
Inside the Cave
There was nothing between; no wall of written tradition; no built up system of culture-his naked mind was confronted by naked earth. He made three idea-discoveries, wresting them from the unknown; the existence of his soul, immortality, the deity. Now, to-day, as I write, I stand in exactly the same position as the Caveman. Written tradition, systems of culture, modes of thought, have for me no existence. If ever they took any hold of my mind it must have been very slight; they have long ago been erased.

You are standing inside a cave. There is a fire going here, just inside the cave mouth.

>inv
You are carrying:
  a white orb

>out
Ancient Cave
You are standing outside a cave.

The forest is inpenetrable in all directions. The cave mouth is the only way you see to go.

>go into cave
You can't see any such thing.

>look cave
You can't see any such thing.

* * *

>gonear Ancient Cave
Ancient Cave
Twelve thousand years since the Caveman stood at the mouth of his cavern and gazed out at the night and the stars. He looked again and saw the sun rise beyond the sea. He reposed in the noontide heat under the shade of the trees, he closed his eyes and looked into himself. He was face to face with the earth, the sun, the night; face to face with himself.

You are standing outside a cave.

The forest is inpenetrable in all directions. The cave mouth is the only way you see to go.

>go into cave
Inside the Cave
There was nothing between; no wall of written tradition; no built up system of culture-his naked mind was confronted by naked earth. He made three idea-discoveries, wresting them from the unknown; the existence of his soul, immortality, the deity. Now, to-day, as I write, I stand in exactly the same position as the Caveman. Written tradition, systems of culture, modes of thought, have for me no existence. If ever they took any hold of my mind it must have been very slight; they have long ago been erased.

You are standing inside a cave. There is a fire going here, just inside the cave mouth.

>look
Inside the Cave
You are standing inside a cave. There is a fire going here, just inside the cave mouth.

>out
Ancient Cave
You are standing outside a cave.

The forest is inpenetrable in all directions. The cave mouth is the only way you see to go.

>enter cave
Inside the Cave
You are standing inside a cave. There is a fire going here, just inside the cave mouth.

>leave cave
I only understood you as far as wanting to leave.

>exit cave
I only understood you as far as wanting to exit.

>exit mouth
I only understood you as far as wanting to exit.

>drop orb in fire
You drop the orb into the fire. It carries with it the last of whatever Self you possess and whatever attachments possess you. You are naked.

>look
Inside the Cave
You are standing inside a cave. There is a fire going here, just inside the cave mouth.

>inv
You are carrying:
  a white orb

>look fire
You see nothing special about the campfire.

>drop white orb
Dropped.

>inv
You are carrying nothing.

>out
*** You step out of the mouth of the cave...

From earth and sea and sun, from night, the stars, from day, the trees, the hills, from my own soul-from these I think. I stand this moment at the mouth of the ancient cave, face to face with nature, face to face with the supernatural, with myself. My naked mind confronts the unknown. I see as clearly as the noonday that this is not all; I see other and higher conditions than existence; I see not only the existence of the soul, immortality, but, in addition, I realise a soul-life illimitable; I realise the existence of a cosmos of thought; I realise the existence of an inexpressible entity infinitely higher than deity. I strive to give utterance to a Fourth Idea. The very idea that there is another idea is something gained. The three found by the Cavemen are but stepping-stones: first links of an endless chain. At the mouth of the ancient cave, face to face with the unknown, they prayed. Prone in heart to-day I pray, Give me the deepest soul-life. ***

Would you like to RESTART, RESTORE a saved game, QUIT or UNDO the last command?

* * *

>go near ancient cave
You can't see any such thing.

>gonear ancient cave
Ancient Cave
Twelve thousand years since the Caveman stood at the mouth of his cavern and gazed out at the night and the stars. He looked again and saw the sun rise beyond the sea. He reposed in the noontide heat under the shade of the trees, he closed his eyes and looked into himself. He was face to face with the earth, the sun, the night; face to face with himself.

You are standing outside a cave.

The forest is inpenetrable in all directions. The cave mouth is the only way you see to go.

>PURLOIN white orb
[Purloined.]

>go into cave
Inside the Cave
There was nothing between; no wall of written tradition; no built up system of culture-his naked mind was confronted by naked earth. He made three idea-discoveries, wresting them from the unknown; the existence of his soul, immortality, the deity. Now, to-day, as I write, I stand in exactly the same position as the Caveman. Written tradition, systems of culture, modes of thought, have for me no existence. If ever they took any hold of my mind it must have been very slight; they have long ago been erased.

You are standing inside a cave. There is a fire going here, just inside the cave mouth.

>leave cave
I only understood you as far as wanting to leave.

* * *

>exit cave
I only understood you as far as wanting to exit.

>exit cave mouth
I only understood you as far as wanting to exit.

>leave cave mouth
I only understood you as far as wanting to leave.

>look at cave
It is a wide open cave mouth. You can see smoke and a flicker of light coming from inside.

* * *

>gonear Ancient Cave
Ancient Cave
Twelve thousand years since the Caveman stood at the mouth of his cavern and gazed out at the night and the stars. He looked again and saw the sun rise beyond the sea. He reposed in the noontide heat under the shade of the trees, he closed his eyes and looked into himself. He was face to face with the earth, the sun, the night; face to face with himself.

You are standing outside a cave.

The forest is inpenetrable in all directions. The cave mouth is the only way you see to go.

>PURLOIN white orb
[Purloined.]

* * *

>drop white orb in fire
You drop the orb into the fire. It carries with it the last of whatever Self you possess and whatever attachments possess you. You are naked.

>out
You step out of the mouth of the cave...

From earth and sea and sun, from night, the stars, from day, the trees, the hills, from my own soul-from these I think. I stand this moment at the mouth of the ancient cave, face to face with nature, face to face with the supernatural, with myself. My naked mind confronts the unknown. I see as clearly as the noonday that this is not all; I see other and higher conditions than existence; I see not only the existence of the soul, immortality, but, in addition, I realise a soul-life illimitable; I realise the existence of a cosmos of thought; I realise the existence of an inexpressible entity infinitely higher than deity. I strive to give utterance to a Fourth Idea. The very idea that there is another idea is something gained. The three found by the Cavemen are but stepping-stones: first links of an endless chain. At the mouth of the ancient cave, face to face with the unknown, they prayed. Prone in heart to-day I pray, Give me the deepest soul-life.

    *** IT IS COMPLETE. ***

Would you like to RESTART, RESTORE a saved game, QUIT or UNDO the last command?

* * *

>drop orb
You feel compelled to keep it.

>drop orb in fire
You drop the orb into the fire. It carries with it the last of whatever Self you possess and whatever attachments possess you. You are naked.

>look fire
You see nothing special about the campfire.

>leave cave
I only understood you as far as wanting to leave.

>look cave
Inside the Cave
You are standing inside a cave. There is a fire going here, just inside the cave mouth.

>leave
You step out of the mouth of the cave...

From earth and sea and sun, from night, the stars, from day, the trees, the hills, from my own soul-from these I think. I stand this moment at the mouth of the ancient cave, face to face with nature, face to face with the supernatural, with myself. My naked mind confronts the unknown. I see as clearly as the noonday that this is not all; I see other and higher conditions than existence; I see not only the existence of the soul, immortality, but, in addition, I realise a soul-life illimitable; I realise the existence of a cosmos of thought; I realise the existence of an inexpressible entity infinitely higher than deity. I strive to give utterance to a Fourth Idea. The very idea that there is another idea is something gained. The three found by the Cavemen are but stepping-stones: first links of an endless chain. At the mouth of the ancient cave, face to face with the unknown, they prayed. Prone in heart to-day I pray, Give me the deepest soul-life.

    *** IT IS COMPLETE. ***

Would you like to RESTART, RESTORE a saved game, QUIT or UNDO the last command?

>undo
Inside the Cave
[Previous turn undone.]

>look
Inside the Cave
You are standing inside a cave. There is a fire going here, just inside the cave mouth.

>inv
You are carrying nothing.

>leave cave
I only understood you as far as wanting to leave.

* * *

>look at hills
You can't see any such thing.

>look hills
You can't see any such thing.

* * *

>w
Woods
For two thousand years brown autumn dwelt in these woods; the rime of winter whitened the beech clump on the ridge; again the buds came on the wind-blown hawthorn bushes, and in the evening the broad constellation of Orion covered the east. The world turns and now summer comes again.

You are in a small forest at the foot of the hills.

A path here goes east and west.

>w
Garden
It happened once that a man was drowned while bathing, and his body was placed in an outhouse near the garden. I passed the outhouse continually, sometimes on purpose to think about it…

You are in a small garden, neatly kept. There is an outhouse nearby as well.

There is a cottage to the north.
There is a path into the woods to the east.

There is a shovel leaning against the outhouse.

>take shovel
Taken.

>in
(first opening the outhouse door)
It seems to be locked.

>look
Garden
You are in a small garden, neatly kept. There is an outhouse nearby as well.

There is a cottage to the north.
There is a path into the woods to the east.

>n
Cottage
You are standing at the back of a small, brick-faced cottage. It is flanked on either side by a small brick wall, and you can see a lane on the other side. The door to the cottage is open.

There is a garden to the south.

>look lane
You can see a little lane on the other side of the wall.

>look window
You can see people moving around through the windows.

>look house
It is a small, brick building. Flowering vines climb the corners of the windows. The back door is open.

>look cottage
It is a small, brick building. Flowering vines climb the corners of the windows. The back door is open.

>look door
It is a simple wooden door, painting a pale blue. A paned window is set into the upper half of the door.

>go inside
Inside the Cottage
You are inside the cottage, in the kitchen. People in black attire are milling about with finger foods and cups of juice.

You can see a table (on which is a key) here.

>take key
Taken.

>look people
These people look sad and bored. Mostly sad. They are all wearing black clothing.

>look kitchen
It is a quaint little kitchen. It might be cozy for a retired couple - it's a bit crowded right now though.

>look cottage
You can't see any such thing.

>look food
It's just your average funeral fare.

>look drink
It's just your average funeral fare.

>out
Cottage
You are standing at the back of a small, brick-faced cottage. It is flanked on either side by a small brick wall, and you can see a lane on the other side. The door to the cottage is open.

There is a garden to the south.

>s
Garden
You are in a small garden, neatly kept. There is an outhouse nearby as well.

There is a cottage to the north.
There is a path into the woods to the east.

>inv
You are carrying:
  the outhouse key
  a shovel

>look key
You see nothing special about the outhouse key.

>unlock door with key
You unlock the outhouse door.

>go in
(first opening the outhouse door)

Inside the Outhouse
It's an outhouse. The only thing worth noting is the dead body propped up in the corner. The smell is pretty bad, but it's not clear what the source is.

>out
Garden
You are in a small garden, neatly kept. There is an outhouse nearby as well.

There is a cottage to the north.
There is a path into the woods to the east.

>take shovel
You already have that.

>look
Garden
You are in a small garden, neatly kept. There is an outhouse nearby as well.

There is a cottage to the north.
There is a path into the woods to the east.

>in
Inside the Outhouse
It's an outhouse. The only thing worth noting is the dead body propped up in the corner. The smell is pretty bad, but it's not clear what the source is.

>take key
(the key)
You gingerly remove the key from the dead man's pocket.

>out
As you walk out of the outhouse, several men in suits push past you. They hoist the body of the man up and carry him out to a casket waiting in the garden. You look up and realize that all the people from the house are outside now, watching. The casket is shut and brought up to the men's shoulders. They walk back toward the cottage; everyone else follows. Then they are gone.

Garden
You are in a small garden, neatly kept. There is an outhouse nearby as well.

There is a cottage to the north.
There is a path into the woods to the east.

>in
Inside the Outhouse
It's an outhouse. The smell is pretty bad, but it's not clear what the source is.

>out
As you walk out of the outhouse, several men in suits push past you. They hoist the body of the man up and carry him out to a casket waiting in the garden. You look up and realize that all the people from the house are outside now, watching. The casket is shut and brought up to the men's shoulders. They walk back toward the cottage; everyone else follows. Then they are gone.

Garden
You are in a small garden, neatly kept. There is an outhouse nearby as well.

There is a cottage to the north.
There is a path into the woods to the east.

>n
Cottage
You are standing at the back of a small, brick-faced cottage. It is flanked on either side by a small brick wall, and you can see a lane on the other side. The door to the cottage is open.

There is a garden to the south.

>look cottage
It is a small, brick building. Flowering vines climb the corners of the windows. The back door is open.

>look windows
They are just empty windows.

>in
Inside the Cottage
You are inside the cottage, in the kitchen.

You can see a table here.

>look food
You can't see any such thing.

>look people
You can't see any such thing.

>ouit
That's not a verb I recognise.

>out
Cottage
You are standing at the back of a small, brick-faced cottage. It is flanked on either side by a small brick wall, and you can see a lane on the other side. The door to the cottage is open.

There is a garden to the south.

* * *

>inv
You are carrying nothing.

>restart
Are you sure you want to restart?

>y
A Fourth Idea
An Adventure Essay by pladams9
Release 1 / Serial number 180422 / Inform 7 build 6M62 (I6/v6.33 lib 6/12N) SD

CHAPTER III
Three things only have been discovered of that which concerns the inner consciousness since before written history began. Three things only in twelve thousand written, or sculptured, years, and in the dumb, dim time before then. Three ideas the Cavemen primeval wrested from the unknown, the night which is round us still in daylight-the existence of the soul, immortality, the deity. These things found, prayer followed as a sequential result. Since then nothing further has been found in all the twelve thousand years, as if men had been satisfied and had found these to suffice. They do not suffice me. I desire to advance further, and to wrest a fourth, and even still more than a fourth, from the darkness of thought. I want more ideas of soul-life. I am certain that there are more yet to be found.

Hills
You are in a landscape of rolling green hills.

Some woods are to the west.
There are hilltops to the east and south.

>look woods
You can't see any such thing.

>look hills
You can't see any such thing.

>w
Woods
For two thousand years brown autumn dwelt in these woods; the rime of winter whitened the beech clump on the ridge; again the buds came on the wind-blown hawthorn bushes, and in the evening the broad constellation of Orion covered the east. The world turns and now summer comes again.

You are in a small forest at the foot of the hills.

A path here goes east and west.

* * *

>take shovel
Taken.

>n
Cottage
There is so much beyond all that has ever yet been imagined. As I write these words, in the very moment, I feel that the whole air, the sunshine out yonder lighting up the ploughed earth, the distant sky, the circumambient ether, and that far space, is full of soul-secrets, soul-life, things outside the experience of all the ages. The fact of my own existence as I write, as I exist at this second, is so marvellous, so miracle-like, strange, and supernatural to me, that I unhesitatingly conclude I am always on the margin of life illimitable, and that there are higher conditions than existence. Everything around is supernatural; everything so full of unexplained meaning.

You are standing at the back of a small, brick-faced cottage. It is flanked on either side by a small brick wall, and you can see a lane on the other side. The door to the cottage is open.

There is a garden to the south.

>go inside
Inside the Cottage
You are inside the cottage, in the kitchen. People in black attire are milling about with finger foods and cups of juice.

You can see a table (on which is a key) here.

* * *

>take key
Taken.

>out
Cottage
You are standing at the back of a small, brick-faced cottage. It is flanked on either side by a small brick wall, and you can see a lane on the other side. The door to the cottage is open.

There is a garden to the south.

* * *

>s
Garden
You are in a small garden, neatly kept. There is an outhouse nearby as well.

There is a cottage to the north.
There is a path into the woods to the east.

>unlock door with key
You unlock the outhouse door.

* * *

>go in
(first opening the outhouse door)

Inside the Outhouse
It's an outhouse. The only thing worth noting is the dead body propped up in the corner. The smell is pretty bad, but it's not clear what the source is.

>take key
(the key)
You gingerly remove the key from the dead man's pocket.

>out
Garden
As you walk out of the outhouse, several men in suits push past you. They hoist the body of the man up and carry him out to a casket waiting in the garden. You look up and realize that all the people from the house are outside now, watching. The casket is shut and brought up to the men's shoulders. They walk back toward the cottage; everyone else follows. Then they are gone.

>inv
You are carrying:
  the boathouse key
  the outhouse key
  a shovel

>e
Woods
You are in a small forest at the foot of the hills.

A path here goes east and west.

>e
Hills
You are in a landscape of rolling green hills.

Some woods are to the west.
There are hilltops to the east and south.

>s
Hilltop
How many words it has taken to describe so briefly the feelings and the thoughts that came to me by the tumulus; thoughts that swept past and were gone, and were succeeded by others while yet the shadow of the mound had not moved from one thyme flower to another, not the breadth of a grass blade. Softly breathed the sweet south wind, gently the yellow corn waved beneath; the ancient, ancient sun shone on the fresh grass and the flower, my heart opened wide as the broad, broad earth. I spread my arms out, laying them on the sward, seizing the grass, to take the fulness of the days. Could I have my own way after death I would be burned on a pyre of pine-wood, open to the air, and placed on the summit of the hills. Then let my ashes be scattered abroad-not collected urn an urn-freely sown wide and broadcast. That is the natural interment of man-of man whose Thought at least has been among the immortals; interment in the elements. Burial is not enough, it does not give sufficient solution into the elements speedily; a furnace is confined. The high open air of the topmost hill, there let the tawny flame lick up the fragment called the body; there cast the ashes into the space it longed for while living. Such a luxury of interment is only for the wealthy; I fear I shall not be able to afford it. Else the smoke of my resolution into the elements should certainly arise in time on the hill-top.

You are on top of a tall hill. There is a mass of stripped trees gathered into a funeral pyre at the center of the hilltop.

There are paths down the hillsides to the north and southeast.

>look pyre
You see nothing special about the funeral pyre.

>se
Brook
I dip my hand in the brook and feel the stream; in an instant the particles of water which first touched me have floated yards down the current, my hand remains there. I take my hand away, and the flow-the time-of the brook does not exist to me. The great clock of the firmament, the sun and the stars, the crescent moon, the earth circling two thousand times, is no more to me than the flow of the brook when my hand is withdrawn; my soul has never been, and never can be, dipped in time.

You are next to a brook of water.

There are hills both to the north and northwest.
To the east, the brook flows down to the seashore.

>look brook
It is a small stream of water, bubbling up from some hidden place among the hills and flowing down to join the greater waters of the sea. Who knows where it will go from there?

>e
Seashore
The supernatural miscalled, the natural in truth, is the real. To me everything is supernatural. How strange that condition of mind which cannot accept anything but the earth, the sea, the tangible universe! Without the misnamed supernatural these to me seem incomplete, unfinished. Without soul all these are dead. Except when I walk by the sea, and my soul is by it, the sea is dead. Those seas by which no man has stood-which no soul has been-whether on earth or the planets, are dead. No matter how majestic the planet rolls in space, unless a soul be there it is dead.

You are standing on a small beach, nestled into an equally small cove. There is a boathouse nearby.

A path leads away from the shore to the west.

>unlock door with key
Which do you mean, the boathouse key or the outhouse key?

>unlock door with boathouse key
You unlock the boathouse-door.

>look
Seashore
You are standing on a small beach, nestled into an equally small cove. There is a boathouse nearby.

A path leads away from the shore to the west.

>look cove
The water laps against the shore quietly.

>look  cottage
You can't see any such thing.

>look house
You can't see any such thing.

>look forest
You can't see any such thing.

>look cove
The water laps against the shore quietly.

>look boathouse
It's a boathouse on the edge of the water.

>look boathouse door
It is the door leading into the boathouse.

>look door
It is the door leading into the boathouse.

>look
Seashore
You are standing on a small beach, nestled into an equally small cove. There is a boathouse nearby.

A path leads away from the shore to the west.

>in
(first opening the boathouse-door)

Inside the Boathouse
You are inside the boathouse. There is a small rowboat here.

You can see a box of matches here.

>look matches
A standard box of matches. There are plenty of matches inside, in decent condition.

>take matches
Taken.

>look boat
A small rowboat. No way to row it though - it's oars are missing.

>take boat
That's hardly portable.

>get in boat
Not right now.

>look water
You can't see any such thing.

>look floor
You can't see any such thing.

>leave
Seashore
You are standing on a small beach, nestled into an equally small cove. There is a boathouse nearby.

A path leads away from the shore to the west.

>n
You can't go that way.

>w
Brook
You are next to a brook of water.

There are hills both to the north and northwest.
To the east, the brook flows down to the seashore.

>nw
Hilltop
You are on top of a tall hill. There is a mass of stripped trees gathered into a funeral pyre at the center of the hilltop.

There are paths down the hillsides to the north and southeast.

>light
What do you want to light?

>light pyre
You've got some matches, but you'll need some tinder. Something that burns easily.

>n
Hills
You are in a landscape of rolling green hills.

Some woods are to the west.
There are hilltops to the east and south.

>e
Hilltop
There were grass-grown tumuli on the hills to which of old I used to walk, sit down at the foot of one of them, and think. Some warrior had been interred there in the antehistoric times. The sun of the summer morning shone on the dome of sward, and the air came softly up from the wheat below, the tips of the grasses swayed as it passed sighing faintly, it ceased, and the bees hummed by to the thyme and heathbells. I became absorbed in the glory of the day, the sunshine, the sweet air, the yellowing corn turning from its sappy green to summer's noon of gold, the lark's song like a waterfall in the sky. I felt at that moment that I was like the spirit of the man whose body was interred in the tumulus; I could understand and feel his existence the same as my own. He was as real to me two thousand years after interment as those I had seen in the body. The abstract personality of the dead seemed as existent as thought. As my thought could slip back the twenty centuries in a moment to the forest-days when he hurled the spear, or shot with the bow, hunting the deer, and could return again as swiftly to this moment, so his spirit could endure from then till now, and the time was nothing.

You are on a hilltop inhabited only by an ancient warrior in his burial mound.

A small wood can be seen in the distance to the west.
A brook lies down the hill to the south.

>dig into mound
You dig into the burial mound, and soon there is an opening leading inside.

>in
You crawl into the hole in the side of the burial mound.

Inside the Tumulus
There is no separation-no past; eternity, the Now, is continuous. When all the stars have revolved they only produce Now again. The continuity of Now is for ever. So that it appears to me purely natural, and not super natural, that the soul whose temporary frame was interred in this mound should be existing as I sit on the sward. How infinitely deeper is thought than the million miles of the firmament! The wonder is here, not there; now, not to be, now always. Things that have been miscalled supernatural appear to me simple, more natural than nature, than earth, than sea, or sun. It is beyond telling more natural that I should have a soul than not, that there should be immortality; I think there is much more than immortality. It is matter which is the supernatural, and difficult of under-standing. Why this clod of earth I hold in my hand? Why this water which drops sparkling from my fingers dipped in the brook? Why are they at all? When? How? What for? Matter is beyond understanding, mysterious, impenetrable; I touch it easily, comprehend it, no. Soul, mind-the thought, the idea-is easily understood, it understands itself and is conscious.

You are inside of the hilltop burial mound.

There is a hole in the wall of the mound letting in light and air from the outside.

You can see a skeleton and a scrap of paper here.

>take paper
Taken.

>read paper
It is a piece of paper. On it is written:

The silky grass sighs as the wind comes carrying the blue butterfly more rapidly than his wings. A large humble-bee burrs round the green dome against which I rest; my hands are scented with thyme. The sweetness of the day, the fulness of the earth, the beauteous earth, how shall I say it?

That there is no knowing, in the sense of written reasons, whether the soul lives on or not, I am fully aware. I do not hope or fear. At least while I am living I have enjoyed the idea of immortality, and the idea of my own soul. If then, after death, I am resolved without exception into earth, air, and water, and the spirit goes out like a flame, still I shall have had the glory of that thought.

>take skeleton
Leave him be - better that he continue here toward dissolution.

>look skeleton
Two thousand years being a second to the soul could not cause its extinction. It was no longer to the soul than my thought occupied to me. Recognising my own inner consciousness, the psyche, so clearly, death did not seem to me to affect the personality. In dissolution there was no bridgeless chasm, no unfathomable gulf of separation; the spirit did not immediately become inaccessible, leaping at a bound to an immeasurable distance. Look at another person while living; the soul is not visible, only the body which it animates. Therefore, merely because after death the soul is not visible is no demonstration that it does not still live. The condition of being unseen is the same condition which occurs while the body is living, so that intrinsically there is nothing exceptionable, or supernatural, in the life of the soul after death. Resting by the tumulus, the spirit of the man who had been interred there was to me really alive, and very close. This was quite natural, as natural and simple as the grass waving in the wind, the bees humming, and the larks" songs. Only by the strongest effort of the mind could I understand the idea of extinction; that was supernatural, requiring a miracle; the immortality of the soul natural, like earth. Listening to the sighing of the grass I felt immortality as I felt the beauty of the summer morning, and I thought beyond immortality, of other conditions, more beautiful than existence, higher than immortality.

It is the skeleton of a long-dead warrior, buried within this tumulus - his body's final home.

>look skeleton
It is the skeleton of a long-dead warrior, buried within this tumulus - his body's final home.

>leave
Hilltop
You are on a hilltop inhabited only by an ancient warrior in his burial mound.

A small wood can be seen in the distance to the west.
A brook lies down the hill to the south.
There is a hole leading into the burial mound.

>w
Hills
You are in a landscape of rolling green hills.

Some woods are to the west.
There are hilltops to the east and south.

I beg your pardon?

>s
Hilltop
You are on top of a tall hill. There is a mass of stripped trees gathered into a funeral pyre at the center of the hilltop.

There are paths down the hillsides to the north and southeast.

>light pyre
You set fire to the scrap of paper and watch as the flames of the pyre lick into the air. When it is done, something glints from the pile of ashes.

>look ashes
In the pile of ashes are a white orb and a black orb.

>look pyre
In the pile of ashes are a white orb and a black orb.

>look
Hilltop
You are on top of a tall hill. There is a large pile of ashes at the center of the hilltop.

There are paths down the hillsides to the north and southeast.

>look in pyre
In the pile of ashes are a white orb and a black orb.

>look ashes
In the pile of ashes are a white orb and a black orb.

>take black orb
As you reach for the black orb, the white one glows and then dissolves.

>look
Hilltop
You are on top of a tall hill. There is a large pile of ashes at the center of the hilltop.

There are paths down the hillsides to the north and southeast.

>look ashes
The pile of ashes is empty.

>n
Hills
You are in a landscape of rolling green hills.

Some woods are to the west.
There are hilltops to the east and south.

>e
Hilltop
You are on a hilltop inhabited only by an ancient warrior in his burial mound.

A small wood can be seen in the distance to the west.
A brook lies down the hill to the south.
There is a hole leading into the burial mound.

>go into hole
You crawl into the hole in the side of the burial mound.

Inside the Tumulus
Upon entering the burial mound, you are overcome with a connection to the ancient warrior and with a sense of the meaningless of time. The black orb pulses; you feel yourself freed from the restraints of the present and transported...

Ancient Hilltop
Realising that spirit, recognising my own inner consciousness, the psyche, so clearly, I cannot understand time. It is eternity now. I am in the midst of it. It is about me in the sunshine; I am in it, as the butterfly floats in the light-laden air. Nothing has to come; it is now. Now is eternity; now is the immortal life. Here this moment, by this tumulus, on earth, now; I exist in it. The years, the centuries, the cycles are absolutely nothing; it is only a moment since this tumulus was raised; in a thousand years it will still be only a moment. To the soul there is no past and no future; all is and will be ever, in now. For artificial purposes time is mutually agreed on, but is really no such thing. The shadow goes on upon the dial, the index moves round upon the clock, and what is the difference? None whatever. If the clock had never been set going, what would have been the difference? There may be time for the clock, the clock may make time for itself; there is none for me.

You seem to have lost all your possessions - the black orb being the only exception.

You are on a hilltop nearly identical to the one which held the tumulus, but there is nothing here but grass and, surrounding the hill, forest.

A path to the east leads down into the forest.

>inv
You are carrying:
  a black orb
  a box of matches
  the boathouse key
  the outhouse key
  a shovel

>out
Hilltop
You are on a hilltop inhabited only by an ancient warrior in his burial mound.

A small wood can be seen in the distance to the west.
A brook lies down the hill to the south.
There is a hole leading into the burial mound.

>in
You crawl into the hole in the side of the burial mound.

Inside the Tumulus
Upon entering the burial mound, you are overcome with a connection to the ancient warrior and with a sense of the meaningless of time. The black orb pulses; you feel yourself freed from the restraints of the present and transported...

Realising that spirit, recognising my own inner consciousness, the psyche, so clearly, I cannot understand time. It is eternity now. I am in the midst of it. It is about me in the sunshine; I am in it, as the butterfly floats in the light-laden air. Nothing has to come; it is now. Now is eternity; now is the immortal life. Here this moment, by this tumulus, on earth, now; I exist in it. The years, the centuries, the cycles are absolutely nothing; it is only a moment since this tumulus was raised; in a thousand years it will still be only a moment. To the soul there is no past and no future; all is and will be ever, in now. For artificial purposes time is mutually agreed on, but is really no such thing. The shadow goes on upon the dial, the index moves round upon the clock, and what is the difference? None whatever. If the clock had never been set going, what would have been the difference? There may be time for the clock, the clock may make time for itself; there is none for me.

Ancient Hilltop
There is so much beyond all that has ever yet been imagined. As I write these words, in the very moment, I feel that the whole air, the sunshine out yonder lighting up the ploughed earth, the distant sky, the circumambient ether, and that far space, is full of soul-secrets, soul-life, things outside the experience of all the ages. The fact of my own existence as I write, as I exist at this second, is so marvellous, so miracle-like, strange, and supernatural to me, that I unhesitatingly conclude I am always on the margin of life illimitable, and that there are higher conditions than existence. Everything around is supernatural; everything so full of unexplained meaning.

You are on a hilltop nearly identical to the one which held the tumulus, but there is nothing here but grass and, surrounding the hill, forest.

A path to the east leads down into the forest.

* * *

>e
Ancient Forest
When I consider that I dwell this moment in the eternal Now that has ever been and will be, that I am in the midst of immortal things this moment, that there probably are Souls as infinitely superior to mine as mine to a piece of timber, what then, pray, is a "miracle"? As commonly understood, a "miracle" is a mere nothing. I can conceive soul-works done by simple will or thought a thousand times greater. I marvel that they do not happen this moment. The air, the sunlight, the night, all that surrounds me seems crowded with inexpressible powers, with the influence of Souls, or existences, so that I walk in the midst of immortal things. I myself am a living witness of it. Sometimes I have concentrated myself, and driven away by continued will all sense of outward appearances, looking straight with the full power of my mind inwards on myself. I find "I" am there; an "I" I do not wholly understand, or know-something is there distinct from earth and timber, from flesh and bones. Recognising it, I feel on the margin of a life unknown, very near, almost touching it: on the verge of powers which if I could grasp would give me an immense breadth of existence, an ability to execute what I now only conceive; most probably of far more than that. To see that "I" is to know that I am surrounded with immortal things. If, when I die, that "I" also dies, and becomes extinct, still even then I have had the exaltation of these ideas.

You are standing in a forest. It appears to be completely unblemished by man.

A path leads to the west and east.

>e
The path quickly disappears among the overgrowth, and you find yourself racing through the forest blindly. Then you see the light of a clearing up ahead. You burst out into the open, sure that you will not be able to find your way back through the forest.

Ancient Cave
Twelve thousand years since the Caveman stood at the mouth of his cavern and gazed out at the night and the stars. He looked again and saw the sun rise beyond the sea. He reposed in the noontide heat under the shade of the trees, he closed his eyes and looked into himself. He was face to face with the earth, the sun, the night; face to face with himself.

You are standing outside a cave.

The forest is inpenetrable in all directions. The cave mouth is the only way you see to go.

>in
Inside the Cave
There was nothing between; no wall of written tradition; no built up system of culture-his naked mind was confronted by naked earth. He made three idea-discoveries, wresting them from the unknown; the existence of his soul, immortality, the deity. Now, to-day, as I write, I stand in exactly the same position as the Caveman. Written tradition, systems of culture, modes of thought, have for me no existence. If ever they took any hold of my mind it must have been very slight; they have long ago been erased.

You are standing inside a cave. There is a fire going here, just inside the cave mouth.

>inv
You are carrying:
  a black orb

>drop orb
You feel compelled to keep it.

* * *

>drop orb in fire
You drop the orb into the fire. It carries with it the last of whatever Self you possess and whatever attachments possess you. You are naked.

>put orb in fire
You can't see any such thing.

>inv
You are carrying nothing.

>out
You step out of the mouth of the cave...

From earth and sea and sun, from night, the stars, from day, the trees, the hills, from my own soul-from these I think. I stand this moment at the mouth of the ancient cave, face to face with nature, face to face with the supernatural, with myself. My naked mind confronts the unknown. I see as clearly as the noonday that this is not all; I see other and higher conditions than existence; I see not only the existence of the soul, immortality, but, in addition, I realise a soul-life illimitable; I realise the existence of a cosmos of thought; I realise the existence of an inexpressible entity infinitely higher than deity. I strive to give utterance to a Fourth Idea. The very idea that there is another idea is something gained. The three found by the Cavemen are but stepping-stones: first links of an endless chain. At the mouth of the ancient cave, face to face with the unknown, they prayed. Prone in heart to-day I pray, Give me the deepest soul-life.

    *** IT IS COMPLETE. ***

Would you like to RESTART, RESTORE a saved game, QUIT or UNDO the last command?

* * *

>look ashes
In the pile of ashes are a white orb and a black orb.

>take white orb
As you reach for the white orb, the black one fades into nothingness.

>n
Hills
You are in a landscape of rolling green hills.

Some woods are to the west.
There are hilltops to the east and south.

* * *

>e
Hilltop
You are on a hilltop inhabited only by an ancient warrior in his burial mound.

A small wood can be seen in the distance to the west.
A brook lies down the hill to the south.
There is a hole leading into the burial mound.

>go into hole
You crawl into the hole in the side of the burial mound.

Inside the Tumulus
You are inside of the hilltop burial mound.

There is a hole in the wall of the mound letting in light and air from the outside.

You can see a skeleton here.

>leave
Hilltop
You are on a hilltop inhabited only by an ancient warrior in his burial mound.

A small wood can be seen in the distance to the west.
A brook lies down the hill to the south.
There is a hole leading into the burial mound.

>s
Brook
You are next to a brook of water.

There are hills both to the north and northwest.
To the east, the brook flows down to the seashore.

>e
Seashore
You are standing on a small beach, nestled into an equally small cove. There is a boathouse nearby.

A path leads away from the shore to the west.

>e
You can't go that way.

>in
Inside the Boathouse
You enter the boathouse. Here within earshot of the ocean waves, you feel the layers of Self begin to fall away, as if you were beginning to dissolve into the salt air. A mild tone begins to emanate from the white orb, and you feel a peace come over you. You step into the boat and push out into the water, leaving everything but the orb behind.

Ocean of Mind
There is an immense ocean over which the mind can sail, upon which the vessel of thought has not yet been launched. I hope to launch it. The mind of so many thousand years has worked round and round inside the circle of these three ideas as a boat on an inland lake. Let us haul it over the belt of land, launch on the ocean, and sail outwards.

You are floating in a boat in a vast ocean. The waves rock gently.

You have no oars, so there is no place to go. You can do nothing but wait.

>look oars
You don't have any! There weren't ever any to begin with! How do you think that guy died?

>look water
The waves are surprisingly small, but that doesn't make you feel safe.

>wait
As I move about in the sunshine I feel in the midst of the supernatural: in the midst of immortal things. It is impossible to wrest the mind down to the same laws that rule pieces of timber, water, or earth. They do not control the soul, however rigidly they may bind matter. So full am I always of a sense of the immortality now at this moment round about me, that it would not surprise me in the least if a circumstance outside physical experience occurred. It would seem to me quite natural. Give the soul the power it conceives, and there would be nothing wonderful in it.

* * *

>wait
Time and Self seem to slip away, and when they seem almost to be gone, a strip of land looms before you. Your boat washes gently to shore.

Eternity's Shore
Time has never existed, and never will; it is a purely artificial arrangement. It is eternity now, it always was eternity, and always will be. By no possible means could I get into time if I tried. I am in eternity now and must there remain. Haste not, be at rest, this Now is eternity. Because the idea of time has left my mind-if ever it had any hold on it-to me the man interred in the tumulus is living now as I live. We are both in eternity.

You are on a beach of white stones surrounded by forest.

There is a path into the forest to the north.

>look stones
The stones that cover the beach look like white quartz. Each is angular but not sharp, and they range from the size of your fist to the size of your head.

>look shore
The stones that cover the beach look like white quartz. Each is angular but not sharp, and they range from the size of your fist to the size of your head.

>look forest
You can't see any such thing.

>n
The path quickly disappears among the overgrowth, and you find yourself racing through the forest blindly. Then you see the light of a clearing up ahead. You burst out into the open, sure that you will not be able to find your way back through the forest.

Ancient Cave
Twelve thousand years since the Caveman stood at the mouth of his cavern and gazed out at the night and the stars. He looked again and saw the sun rise beyond the sea. He reposed in the noontide heat under the shade of the trees, he closed his eyes and looked into himself. He was face to face with the earth, the sun, the night; face to face with himself.

You are standing outside a cave.

The forest is inpenetrable in all directions. The cave mouth is the only way you see to go.

>in
Inside the Cave
There was nothing between; no wall of written tradition; no built up system of culture-his naked mind was confronted by naked earth. He made three idea-discoveries, wresting them from the unknown; the existence of his soul, immortality, the deity. Now, to-day, as I write, I stand in exactly the same position as the Caveman. Written tradition, systems of culture, modes of thought, have for me no existence. If ever they took any hold of my mind it must have been very slight; they have long ago been erased.

You are standing inside a cave. There is a fire going here, just inside the cave mouth.

>look fire
It is a small campfire, well built. You try to remember starting it but can't. You must have though - you're the only one here.

>inv
You are carrying:
  a white orb

>put orb in fire
You drop the orb into the fire. It carries with it the last of whatever Self you possess and whatever attachments possess you. You are naked.

>inv
You are carrying nothing.